##########
##@   #  #
#  *$. .##
# ## $   #
# * .##$.#
#  .$.$. #
#  $  $  #
## # $#$##
#  #  . .#
##########