######
#    #
# $ @#
#   .#
######