#######
#@    #
#  $ .#
#$ #  #
#.    #
#######